1111111111111111111111111111111111111111111111144444444444444111111111111111111111111111111111111111111111111111111111111111111111111111111111111111111111111111111111111111111111111111111111111111111111111111111
11111111111111111111111c1111111111111111111111114444444444441111111111111111111111114444111111111111111111111111111111111111111111c11111111111111111111111111111111111111111111111111111111111111111111111111111111
1111111111111111111111c1c1111111111111111111111114444444444111111111111111111111111111111111111111111111111111111111111111111111144411111111111c1111111111111111111111111111111111111111111111111111111111111111111
111111111111111111111c111c1111111111111111111111114444444411111111111111111114444111111111111111111111111111111111111111111111111111111111111c111c111111111111111111111111111111111111111111111111111114444111111a1
1111111111111111444511111111111111111111111111111114444441111111111111111111111111111111111111111111111111111111111111111111111111111111111111111111111111111111111111111111111111111111111111111111111111111113331
1111111111111111111111111111111111111111111111111111444411111111111111111111111111111111111111111111111111444411111111111111444444444444444444111111111111111111111111111111111111111111111111111144441111111112221
11111111111111111111113111111111454411111111111111111111111111111111111145441111111111111111111111111111111111111111144411111111111t1111111111111111111133331111111111111111111111111111111111111111111111111112221
1111111111111111t11113211111111111111111111133111111111111133311111111111111111111111111111111111111114441111111111111111111111111111111111111111111111322221111111111111111111111114441111111444111111111111112221
111111111111111111113221114441111111111111132211g11111g111122231111111111111111111111111111111111111111111111111444111111131111111111111111111131111113222221113311133113311113111111111111111111111111111111112221
111111111111111111132221111111111111111111322233333333333332222311111133333111111111111111111111111111111111111111111111132111g1c11c1c11cg11c1121111132222221112211122112211332333111111144411111111111111111112221
3333333333333333333222211111111333333333332222222222222222222222333333222223331111111111333333333333331111111111111333333223333333333333333333323333322222221112211122112211222222111111111111111111111111111112221
2222222222222222222222211111111222222222222222222222222222222222222222222222221111111111222222222222221111111111111222222222222222222222222222222222222222221112211122112211222222111111111111111111111111111112221
