00000000000000000000000000000000000000000000000000000000000000
00000000000000000000000000000000000000000004444400000000000000
00000000000000000444444440000000000000000444444444000000000000
00000000000000000000000000000000000000000004444400000000000000
00000000000000000000000000000000000000000000000000000000000000
00000000000000000000000000000000000000000000000000000000000000
00000000000000444000000000000004440000000000000000000000000000
00000000000004444400000000000444444400000000000000000000000000
00000000000000444000000000000004440000000000000000000000000000
00000000000000000000000000000000000000000000000000000000000000
00000000444000000000000000000000000000000000000000000000000000
00000004444400000000000000000000044444444400000000000000000000
00000000444000000000000000000000000000000000000000000000000000
00000000000000000000000000000000000000000000000000000000000000
00000000000000000000000000000000000000000000000000000000000000
00000000000000056000000000000000000000000000000000000000000000
00005550000000000000000000000000000000000000000056500000000000
00000000000000000000000000111110111000000000000000000000000000
00000000000000111100000001222210122100000770000000000000000000
11111111130311222211111111111110111111111771111111111111111111
22222222220222222222222222222220222222222772222222222222222222
22222222220222222222222222222220222222222772222222222222222222
22222222220222222222222222222220222222222772222222222222222222
22222222220222222222222222222220222222222772222222222222222222
