0000000000000000000000000000000000000000000000000000000000000000000000000000000000000000000000000000
0000000000000000000000000000000000000000000000000000000000000000000000000000000000000000000000000000
0000000000000000001110000000000000000000000000000000000000000000000000000000000000000000000000000000
0001100000011000001111000000000000000000000000000000000000000000000000000000000000000000000000000000
0001100000011000001111000000000000000000000000000000000000000000000000000000000000000000000000000000
0000000000011000000110000000000000000000000000000000000000000000000000000000000000000000000000000000
0000000000000000000000000000000000000000000000000000000000000000000000000000000000000000000000000000
0000000000000000000000000111000000000000000000000000000000000000000000000000000000000000000000000000
0000000000000000000000000111100000000000000000000000000000000000000000000000000000000000000000000000
0000000000011000000111110111110000000000000000000000000000000000000000000000000000000000000000000000
1111111110011110000111110111110000000000000000000000000000000000000000000000000000000000000000000000
1111111111011111111111110111111000000000000000000000000000000000000000000000000000000000000000000000