2222222222222222222222222222222222222222222222222222222222222222222222222222222222222222222222222222
2222222222222222222222222222222222222222222222222222222222222222222232222222222222222222222221222222
2222222222222222222322222222222222222222222222222222222222213122222222222222222222222222222221222222
2222222222222222222222222222222222222222222222221222222222222222222222222222222222222222222221222222
2222222222222222222222211122222222222222222222222222222222222222222222222222222222222222222221222222
2222222222222222222222222222222222222222223322222222222222111112222111222222222222222222222221222222
2222222222222222221112222222213122222222222222222222222222222222222222222222222222222222222221222222
2222222222222222222222222222222222222222222222211122222222222222222222222222222222222222112221221212
2221331222222222122222111112222222222222222222222222222622222222213131312222222222222222222221221111
2222222222226222222222222222222222222222211112222222222566622222222222222222222222223222222221221111
2222222222265222222222222222266622222222222222222222666555562222222222222222222662222662222221221111
222222222265522222222222222225552hghd22222222222222226555555552222222222222222226552222556222221221111
6666666666555666666666666666655569md62266666666666665555555556666666666666666665551222555666661661111
5555555555555555555555555555555557852255555555555555555555555555555555555555555552221555555555555555